03 03 03 03 03 03 03 03 03 03 03 03 03 03 03 03 03 03 03 03 03 03 03 03 03 03 03 03 03 03 03 03
03 13 06 06 06 06 06 06 06 06 06 06 06 06 18 06 06 06 18 06 06 06 06 06 06 06 06 06 06 06 14 03
03 05 04 26 04 04 04 04 04 30 04 30 04 04 05 04 30 04 05 04 04 04 04 04 04 04 04 04 04 04 05 03
03 05 03 27 03 24 03 03 03 31 03 31 03 03 05 03 31 03 05 03 03 03 03 03 03 03 03 03 03 03 05 03
03 05 03 03 03 03 03 03 03 03 03 03 03 03 05 03 03 03 05 03 03 03 03 03 03 03 03 03 03 03 05 03
03 05 03 03 03 03 03 03 03 03 03 03 03 03 05 25 03 03 05 03 03 03 03 03 03 03 03 03 03 03 05 03
03 05 03 03 13 06 06 06 06 14 03 03 03 03 05 03 03 03 05 03 03 03 03 03 03 03 03 03 03 03 05 03
03 05 03 03 05 04 04 30 04 05 03 03 03 03 08 03 03 03 05 03 03 03 03 03 03 03 03 03 03 03 05 03
03 05 03 03 05 03 03 31 03 05 03 03 03 03 04 03 03 20 05 03 03 03 03 03 03 03 03 03 03 03 05 03
03 05 03 03 05 21 03 03 03 05 03 03 03 03 03 03 03 03 08 03 03 03 03 03 03 03 03 03 03 03 05 03
03 05 03 03 05 03 03 03 03 05 03 03 03 03 03 03 03 03 04 03 03 03 03 03 03 03 03 03 03 21 05 03
03 05 03 03 05 03 03 23 03 12 06 06 06 06 14 03 03 03 03 03 03 03 03 03 03 03 03 03 03 03 05 03
03 05 03 03 05 03 03 03 03 04 28 04 26 04 05 03 03 03 03 03 03 03 03 03 03 03 03 03 03 03 05 03
03 05 03 03 05 03 03 03 03 03 29 03 27 03 05 03 03 03 03 03 03 03 03 03 03 03 03 03 03 03 05 03
03 05 03 03 05 03 03 03 03 03 03 03 03 03 05 03 03 03 07 03 20 03 03 03 03 03 03 03 03 03 05 03
03 05 03 03 05 03 03 03 03 03 03 03 03 03 05 03 03 03 05 03 03 03 03 03 03 03 03 03 03 23 05 03
03 05 03 03 05 03 03 03 03 07 03 03 03 03 05 03 21 03 05 03 03 03 03 03 03 03 03 03 03 03 05 03
03 05 03 03 05 24 03 03 03 05 03 03 03 03 05 03 03 03 05 03 03 21 03 03 03 03 03 03 03 03 05 03
03 05 03 03 08 03 03 03 03 05 03 03 03 03 12 06 06 06 15 03 03 03 03 03 03 24 03 03 03 03 05 03
03 05 03 03 04 03 03 03 20 05 03 03 03 03 04 04 04 04 05 03 24 03 03 03 03 03 03 03 03 03 05 03
03 05 03 03 03 03 03 03 03 05 03 03 03 03 03 03 03 03 05 03 03 03 03 03 22 03 03 03 03 03 05 03
03 05 03 03 03 03 03 03 03 05 23 25 03 03 03 03 03 03 05 03 03 03 03 03 03 03 03 03 03 25 05 03
03 12 06 06 06 06 06 06 06 16 06 06 06 06 06 06 06 06 16 06 06 06 06 06 06 06 06 06 06 06 11 03
03 03 03 03 03 03 03 03 03 03 03 03 03 03 03 03 03 03 03 03 03 03 03 03 03 03 03 03 03 03 03 03
