02 02 02 02 02 02 02 02 02 02 02 02 02 02 02 02 02 02 02 02 02 02 02 02 02 02 02 02 02 02 02 02 02 02 02 02 02 02 02 02
02 02 02 02 02 02 02 02 02 13 06 06 06 06 06 06 18 06 06 06 06 06 06 06 06 06 06 06 18 06 06 06 06 06 06 06 06 06 14 02
02 02 02 02 02 02 02 02 02 05 04 30 04 28 04 04 05 04 04 04 26 04 26 04 26 04 04 04 05 04 30 04 30 04 30 04 30 04 05 02
02 02 13 06 06 06 06 06 06 11 03 31 03 29 03 25 05 03 22 03 27 03 27 03 27 03 03 04 05 03 31 03 31 03 31 03 31 03 05 02
02 02 05 04 30 04 28 04 26 04 03 03 03 03 03 03 05 03 03 03 03 03 03 03 03 03 03 23 05 03 03 03 03 03 03 03 03 03 05 02
02 02 05 03 31 03 29 03 27 03 25 03 03 03 03 21 05 03 03 03 10 06 06 06 06 14 03 03 05 21 03 03 03 03 03 03 03 03 05 02
02 02 05 03 03 03 03 03 03 03 03 03 03 03 23 03 05 03 03 03 04 30 04 28 04 05 03 03 05 03 03 03 03 03 03 03 25 03 05 02
02 02 05 03 03 03 03 03 03 03 03 03 03 03 03 03 05 03 03 03 03 31 03 29 03 05 24 03 05 03 03 03 03 03 03 03 03 03 05 02
02 02 05 03 03 03 03 03 03 03 03 03 03 03 03 03 05 03 03 03 03 03 03 03 03 05 03 03 12 06 09 03 03 03 13 06 06 06 11 02
02 02 12 06 06 14 03 03 03 03 03 03 03 03 03 03 12 06 14 03 03 03 03 03 03 05 03 03 26 04 04 03 03 03 05 02 02 02 02 02
02 02 02 02 02 05 03 03 03 03 03 03 03 03 03 03 26 04 05 03 03 03 03 03 03 05 03 03 27 03 03 03 03 03 05 02 02 02 02 02
02 02 02 02 02 05 03 03 03 23 03 03 03 03 03 03 27 03 05 03 03 03 03 03 03 05 03 03 03 03 03 23 03 03 05 02 02 02 02 02
02 02 13 06 06 11 25 03 03 03 03 03 03 03 03 03 03 03 05 03 03 03 03 03 03 05 03 03 03 03 03 03 03 03 05 02 02 02 02 02
02 02 05 04 30 04 03 03 03 03 03 03 03 03 03 03 03 03 05 03 03 03 03 03 03 05 03 03 03 03 03 03 03 03 05 02 02 02 02 02
02 02 05 03 31 03 03 03 03 03 03 03 03 03 03 03 13 06 11 03 03 03 03 03 03 05 23 03 13 06 09 03 03 03 05 02 02 02 02 02
02 02 05 03 03 03 03 03 03 03 03 03 03 03 03 03 05 04 04 03 03 03 03 03 03 05 03 03 05 04 04 03 03 03 12 06 06 14 02 02
02 02 12 06 06 06 06 14 03 03 03 03 03 03 03 03 05 03 03 03 03 03 03 03 03 05 03 03 05 03 03 03 03 03 26 04 04 05 02 02
02 02 02 02 02 02 02 05 20 03 03 03 03 19 03 03 05 03 03 03 03 03 03 25 03 05 03 03 05 03 24 03 03 03 27 03 03 05 02 02
02 02 02 02 02 02 02 05 03 03 03 03 03 03 03 03 05 03 03 03 03 03 03 03 03 05 03 03 05 03 03 03 03 03 03 03 03 05 02 02
02 02 02 02 02 02 02 05 03 03 03 13 06 06 06 06 11 03 03 03 24 03 03 23 03 05 03 25 05 03 03 19 03 03 03 03 03 05 02 02
02 02 02 02 02 02 02 05 03 03 03 05 04 04 04 30 04 03 03 03 03 03 03 03 03 05 03 03 05 03 03 03 03 03 03 21 03 05 02 02
02 13 06 06 06 06 06 11 03 03 03 05 03 25 03 31 03 03 03 03 13 06 06 06 06 11 03 03 05 03 03 03 03 03 03 03 03 05 02 02
02 05 26 04 28 04 30 04 03 03 03 05 03 03 03 03 03 03 03 03 05 04 04 04 04 30 03 03 05 03 03 03 03 03 25 03 03 05 02 02
02 05 27 03 29 03 31 03 03 03 03 05 03 03 03 03 03 13 06 06 11 03 20 03 03 31 03 03 05 03 20 03 03 03 03 03 03 05 02 02
02 05 03 03 03 03 03 03 03 03 03 05 03 03 03 03 03 05 04 30 04 25 03 03 03 03 03 03 05 03 03 03 03 03 03 03 03 05 02 02
02 05 03 03 03 03 03 03 03 03 03 05 03 03 03 03 03 05 03 31 03 03 03 01 03 03 03 03 12 06 18 06 06 06 06 06 06 11 02 02
02 05 03 19 03 03 03 10 06 06 06 11 03 03 03 03 24 05 03 03 03 03 03 03 03 03 03 03 26 04 05 02 02 02 02 02 02 02 02 02
02 05 03 03 03 03 23 04 04 04 26 04 03 03 03 03 03 17 06 06 06 06 06 14 03 03 03 03 27 03 05 02 02 02 02 02 02 02 02 02
02 05 03 03 03 03 03 03 03 03 27 03 03 03 03 03 03 05 02 02 02 02 02 05 03 21 03 03 03 03 05 02 02 02 02 02 02 02 02 02
02 05 03 03 03 03 03 03 03 03 03 03 03 03 03 03 03 05 02 02 02 02 02 05 03 03 03 03 03 03 05 02 02 02 02 02 02 02 02 02
02 12 06 06 06 06 06 06 06 06 06 06 06 06 06 06 06 11 02 02 02 02 02 12 06 06 06 06 06 06 11 02 02 02 02 02 02 02 02 02
02 02 02 02 02 02 02 02 02 02 02 02 02 02 02 02 02 02 02 02 02 02 02 02 02 02 02 02 02 02 02 02 02 02 02 02 02 02 02 02
