06 15 02 02 02 02 02 02 02 09 15 02 02 13 03 03 03 03 03 03 03 11 02 02 02 02 02 02 02 02 02 02 02 09 03 03 03 07 03 03
03 15 01 01 01 01 01 01 01 13 15 24 01 13 03 03 03 07 03 03 03 15 01 01 01 01 01 01 01 01 01 01 01 21 14 14 14 14 17 03
05 15 01 01 01 01 01 01 01 13 15 01 01 21 14 14 17 03 03 03 03 11 01 25 01 01 01 01 01 01 01 01 01 01 01 01 01 01 13 06
03 11 01 01 20 08 23 01 01 09 15 01 01 01 01 01 13 03 03 03 03 15 01 01 01 01 01 01 01 01 01 01 01 01 01 01 24 01 13 03
03 15 01 01 13 03 15 01 01 13 15 01 20 08 23 01 13 03 03 03 03 15 01 01 01 01 01 01 01 01 01 01 01 01 01 01 01 01 13 03
06 15 01 01 09 03 15 01 01 13 15 01 13 07 15 01 13 03 03 07 03 19 12 12 12 12 12 12 12 12 12 12 28 12 12 12 12 12 16 07
03 15 01 01 13 03 15 01 01 13 15 01 13 03 15 01 21 14 10 14 14 14 10 14 14 14 14 10 14 14 14 14 29 14 14 14 14 14 17 03
03 15 01 01 13 04 15 01 01 13 15 01 21 10 22 01 01 01 01 01 01 01 01 01 01 01 01 01 01 01 01 01 01 01 01 01 01 01 09 03
07 11 01 01 13 03 11 01 01 13 15 01 01 01 01 01 01 01 01 01 01 01 01 01 01 01 01 01 01 01 01 01 01 01 01 01 01 01 13 07
03 15 01 01 13 07 15 01 01 13 19 12 12 12 12 12 12 12 08 12 12 12 08 12 12 12 12 12 12 08 12 12 12 08 12 23 01 01 13 03
03 15 01 01 13 03 15 01 01 13 18 14 14 14 17 18 14 14 14 14 14 14 14 14 14 14 14 14 14 14 14 14 14 14 17 15 01 01 13 05
03 11 01 01 09 03 15 01 01 13 11 01 01 01 26 27 01 01 01 01 01 01 01 01 01 01 01 01 01 01 01 01 01 01 09 15 01 01 09 03
03 15 01 01 13 03 15 01 01 13 15 01 01 01 13 15 01 01 01 01 01 01 01 01 01 01 01 01 01 01 01 01 25 01 13 11 01 01 13 03
04 15 01 01 13 05 11 01 01 26 27 01 01 01 13 15 01 01 01 01 24 01 01 01 01 01 01 01 01 01 01 01 01 01 13 15 01 01 13 04
07 15 01 01 09 03 15 01 01 13 19 12 08 12 16 19 12 28 12 12 12 12 08 12 12 08 23 01 01 01 01 01 01 01 13 15 01 01 13 03
06 15 01 01 13 03 19 12 12 16 03 03 03 18 10 14 14 29 14 17 03 04 03 03 05 03 11 01 01 01 01 01 01 01 09 15 01 01 13 05
03 15 01 01 21 14 14 14 10 14 10 14 17 11 01 01 01 01 01 13 18 14 10 14 14 17 15 01 01 01 01 01 01 01 13 15 01 01 13 03
03 15 01 01 01 01 01 01 01 01 01 01 09 15 01 01 01 01 01 13 15 01 01 01 01 09 15 01 01 01 01 01 01 01 13 11 01 01 09 03
05 15 01 01 01 24 01 24 01 24 01 01 13 15 01 25 01 01 01 09 15 01 01 01 01 26 27 01 01 01 01 01 01 01 13 15 01 01 13 03
03 11 01 01 01 01 01 01 01 01 01 01 13 11 01 01 01 01 01 13 15 01 01 01 01 13 19 12 12 12 08 12 12 08 16 15 01 01 13 06
03 15 01 01 01 01 24 01 24 01 01 01 13 19 12 12 08 12 12 16 11 01 01 01 01 09 03 03 04 03 05 18 10 14 17 11 01 01 13 03
03 15 01 01 01 01 01 01 01 01 01 01 09 03 03 05 03 04 07 06 15 01 01 01 01 13 03 06 03 03 03 11 01 01 13 15 01 01 09 03
03 19 08 12 28 12 12 12 08 12 12 12 16 03 06 03 04 03 03 03 15 01 01 01 01 13 18 14 14 14 17 15 01 01 13 11 01 01 13 04
03 18 14 14 29 14 10 14 14 14 10 14 10 14 14 17 03 03 06 03 15 01 01 24 01 09 11 01 01 01 26 27 01 01 13 15 01 01 13 03
03 11 01 01 01 01 01 01 01 01 01 01 01 01 01 09 03 05 03 03 11 01 01 01 01 13 11 01 01 01 13 15 01 01 13 15 01 01 13 03
07 11 01 01 01 01 01 01 01 01 01 01 01 01 01 13 04 03 03 07 15 01 01 01 01 26 27 01 01 01 13 11 01 01 13 15 01 01 13 05
03 15 01 01 01 01 01 01 01 01 01 01 01 01 01 13 18 14 14 14 22 01 01 01 01 09 19 12 12 08 16 15 01 01 26 27 01 01 09 03
03 15 01 01 01 01 01 01 01 01 01 01 01 25 01 09 11 01 01 01 01 01 01 01 01 13 18 14 14 14 17 11 24 01 13 15 01 01 13 03
03 11 01 01 01 01 01 01 01 01 01 01 01 01 01 13 15 01 01 01 01 01 01 01 01 13 15 01 01 01 13 15 01 01 13 15 01 01 09 07
03 19 12 12 12 12 12 12 08 12 12 12 12 12 12 16 15 01 01 01 01 01 01 01 01 13 15 01 24 01 13 19 12 12 16 11 01 24 13 03
03 03 03 03 05 06 03 03 03 04 05 03 03 03 06 03 15 01 01 01 01 01 20 12 08 16 15 01 01 01 09 03 03 04 03 19 12 12 16 06
03 05 03 03 03 04 03 05 03 03 03 06 03 03 05 03 11 01 01 01 01 01 13 03 18 14 22 01 01 01 21 14 10 14 14 10 14 14 17 03
18 10 14 14 14 14 10 14 14 10 14 10 14 14 10 14 22 01 01 01 01 01 13 03 11 01 01 01 01 01 01 01 01 01 01 01 01 01 09 03
11 01 01 01 01 01 01 01 01 01 01 01 01 01 01 01 01 01 01 01 01 01 13 03 15 01 01 01 01 01 01 01 01 01 01 01 24 01 13 04
15 01 01 01 01 01 01 01 01 01 01 01 20 12 12 23 01 01 01 01 01 01 09 04 15 01 01 01 01 01 01 01 01 01 01 01 01 01 13 03
15 01 01 25 01 01 01 01 01 01 01 01 09 03 03 15 01 01 01 01 01 01 13 06 15 01 01 01 01 01 01 01 01 01 01 01 24 01 13 03
15 01 01 01 01 01 01 01 01 01 01 01 21 14 14 22 01 01 01 01 01 01 13 03 15 01 01 01 01 01 01 01 01 01 01 01 01 01 13 03
11 01 01 01 01 01 01 01 01 01 01 01 01 01 01 01 01 01 01 01 01 01 09 03 19 08 12 12 12 08 12 12 12 08 12 08 12 12 16 05
19 12 12 12 12 08 12 12 12 08 12 08 12 12 12 12 12 12 12 12 12 08 16 01 01 01 01 01 01 01 01 01 01 01 01 01 01 01 01 01
01 01 01 01 01 01 01 01 01 01 01 01 01 01 01 01 01 01 01 01 01 01 01 01 01 01 01 01 01 01 01 01 01 01 01 01 01 01 01 01
