05 04 26 04 28 04 26 04 05 04 04 04 04 04 04 04 04 28 04 26 04 28 04 26 04 04 04 04 04 04 04 04
05 01 25 01 27 01 25 01 05 23 22 21 21 21 22 22 01 27 01 25 01 27 01 25 01 01 01 01 01 01 02 03
05 01 01 01 01 01 01 01 05 23 01 01 01 01 01 01 01 01 01 01 01 01 01 01 01 01 01 01 01 01 01 01
05 01 15 17 01 15 17 01 05 22 01 01 01 01 01 01 19 01 01 01 01 01 01 01 01 01 01 01 01 01 01 01
05 01 01 01 01 01 01 01 05 01 01 01 01 01 01 01 19 01 01 01 01 01 01 01 01 01 01 20 01 20 01 01
05 01 15 17 01 15 17 01 05 01 01 15 16 17 01 01 19 01 01 01 01 19 01 19 01 01 01 01 01 01 01 01
05 01 01 01 01 01 01 01 05 01 01 01 01 01 01 01 18 01 01 01 01 19 01 19 01 01 01 20 01 20 01 01
05 01 15 17 01 15 17 01 04 01 01 15 16 17 01 01 01 01 01 01 01 18 01 18 01 01 01 01 01 01 01 01
05 01 01 01 01 01 01 01 01 01 01 01 01 01 01 01 01 01 01 01 01 01 01 01 01 01 01 01 01 01 01 01
05 01 01 19 01 19 01 01 01 01 01 01 01 01 01 01 01 01 01 01 01 19 01 19 01 01 01 01 01 01 01 01
12 06 06 06 06 06 09 01 01 01 01 01 01 01 01 01 01 01 01 01 01 19 01 19 01 01 01 01 13 06 06 06
04 04 04 04 04 04 04 01 01 01 01 01 01 01 01 01 01 01 01 01 01 18 01 18 01 01 01 01 05 26 04 26
23 22 21 22 21 22 24 01 01 01 01 01 01 01 01 01 01 01 01 01 01 01 01 01 01 01 01 01 05 25 01 25
23 01 01 01 01 01 01 01 01 01 01 01 01 01 01 01 01 01 10 06 06 06 06 06 06 06 06 06 11 01 01 01
23 01 01 01 01 01 01 01 01 01 01 01 01 01 01 01 01 01 04 04 31 04 26 04 31 04 26 04 04 01 01 01
23 01 20 01 20 01 01 01 01 01 01 01 01 19 01 07 01 01 01 01 30 01 25 01 30 01 25 01 01 01 01 01
23 01 01 01 01 01 01 01 01 01 01 01 01 18 01 05 01 01 01 01 01 01 01 01 01 01 01 01 01 01 01 01
22 01 01 01 01 01 01 01 01 01 01 01 01 01 01 05 01 01 01 01 01 15 16 16 16 17 01 01 01 01 01 01
01 01 01 01 01 01 01 01 01 01 01 01 01 19 01 05 01 01 01 01 01 01 01 01 01 01 01 01 24 01 24 01
01 01 01 01 01 01 01 01 01 01 01 01 01 18 01 05 01 01 20 01 01 01 01 01 01 01 01 01 01 01 01 01
01 01 01 01 01 01 01 01 01 01 01 01 01 01 01 05 01 01 01 01 01 01 01 01 01 01 01 01 24 01 24 01
01 01 01 01 01 01 01 01 01 01 01 01 01 19 01 05 01 01 20 01 01 01 01 01 01 01 01 01 01 01 01 01
01 01 01 01 01 01 01 01 01 01 01 01 01 18 01 05 01 01 01 01 01 15 16 16 16 17 01 01 24 01 24 01
01 01 01 29 01 29 01 29 01 01 01 01 01 01 01 05 01 01 01 01 01 01 01 01 01 01 01 01 01 01 01 01